neighbor	intended
ACCAATATATAN	ACCAATATAGTA
GGACAGTCTAAN	CGGACAGTCTAA
ATCTAATCTCAN	GATCTAATCTCA
AATTCCGAACTN	GAATTCCGAACT
AGTAGCCTGTTN	CAGTAGCCTGTT
CCTTATCTTGTN	ACCTTATCTTGT
CTGCACCTTGCN	CTGCACCTTGGC
ATAATGTAGGGN	GATAATGTAGGG
TATTAGTGCATN	GTATTAGTGCAT
TGACTATTTCTN	GTGACTATTTCT
ACTATCATGTGN	GACTATCATGTG
TCAAATTGTCAN	GTCAAATTGTCA
ATCATTCCAGTN	CATCATTCCAGT
GAATAGATCGCN	GGAATAGATCGC
AATGATTTGCCN	TAATGATTTGCC
TAGTGGCTCCGN	GTAGTGGCTCCG
ATGCTTTCCTCN	GATGCTTTCCTC
ATCTCTAGTAGN	GATCTCTAGTAG
ACTTCATTGTTN	CACTTCATTGTT
CCGCTAAACATN	GCCGCTAAACAT
ATCTAGACGAAN	GATCTAGACGAA
AGCAATTCTCCN	CAGCAATTCTCC
TTCATCATCGAN	GTTCATCATCGA
CTGGTGCCAATN	GCTGGTGCCAAT
TACAGCTAGTGN	ATACAGCTAGTG
TAAAGCAGGTCN	GTAAAGCAGGTC
GGCAATATCTAN	CGGCAATATCTA
TCATCCGCCCGN	GTCATCCGCCCG
AAGTGCATCCTN	CAAGTGCATCCT
AGCCTCTTGGTN	CAGCCTCTTGGT
CGGCCATCCGCN	GCGGCCATCCGC
GGCATTCTTTTN	GGGCATTCTTTT
GGTAAATGTCGN	GGGTAAATGTCG
TTCGTTAACTCN	CTTCGTTAACTC
CCGCTTTCGAAN	CCCGCTTTCGAA
ACAGCAGAGCAN	GACAGCAGAGCA
GTGAGTTCCGAN	GGTGAGTTCCGA
TAATGCGACTTN	GTAATGCGACTT
TAATATTTCAGN	GTAATATTTCAG
GTTGAGTAATGN	GGTTGAGTAATG
GATGCCGGTTGN	GGATGCCGGTTG
TTTCGTCTCTAN	GTTTCGTCTCTA
TCCGAGACGGTN	GTCCGAGACGGT
ATGCTGAAAATN	GATGCTGAAAAT
GAAATACATGAN	GGAAATACATGA
AATGTTACCGAN	GAATGTTACCGA
TTAAGAAAGGAN	CTTAAGAAAGGA
TACGCCATCGTN	GTACGCCATCGT
GCCCGCGTGCTN	GGCCCGCGTGCT
GATATGAGGTCN	GGATATGAGGTC
CTTCCGTCCAAN	ACTTCCGTCCAA
CGAAAGCAGACN	CCGAAAGCAGAC
GAATTCATCTTN	CGAATTCATCTT
GACTGTCTAGTN	CGACTGTCTAGT
CAAATAGCTACN	GCAAATAGCTAC
CAGGAACAGGAN	GCAGGAACAGGA
CTCGTCTCAACN	ACTCGTCTCAAC
GGTCGATTATTN	AGGTCGATTATT
GTATCTATAATN	GGTATCTATAAT
CTCGCCCTCTTN	CCTCGCCCTCTT
ACTAATTGATCN	GACTAATTGATC
GCCATGAATAAN	GGCCATGAATAA
CTCAAAATATCN	CCTCAAAATATC
GTTATCATCGTN	GGTTATCATCGT
CCATGCAATGTN	CCCATGCAATGT
TTGGAGATTGAN	CTTGGAGATTGA
TATGGAAACAGN	CTATGGAAACAG
GAGTGGGAATCN	GGAGTGGGAATC
CGTCTTTCGATN	TCGTCTTTCGAT
TTAAGCGCTGGN	GTTAAGCGCTGG
CTACACATCTAN	CCTACACATCTA
TGAAAAGCGGGN	GTGAAAAGCGGG
ACGTGCCGGTGN	CACGTGCCGGTG
CATGCTGTAGTN	TCATGCTGTAGT
CAAGGAAGAGAN	CCAAGGAAGAGA
GAAATGTGTTTN	CGAAATGTGTTT
CTGTAAAGCAAN	GCTGTAAAGCAA
ATTCCCGTGCAN	TATTCCCGTGCA
GAAACGCGACCN	GGAAACGCGACC
AGTCTCCCGATN	CAGTCTCCCGAT
CCGATCCGTAAN	CCCGATCCGTAA
ACGACCCCGGAN	CACGACCCCGGA
GCAATAGCGAAN	GGCAATAGCGAA
ATGGCTTATAGN	GATGGCTTATAG
GCCGGTCTCGCN	TGCCGGTCTCGC
TGTCGGGAGTTN	GTGTCGGGAGTT
AGAGGTAGAATN	CAGAGGTAGAAT
CGGAAGCAGTCN	CCGGAAGCAGTC
TTATCTTTCGCN	CTTATCTTTCGC
CTCCGTATAAGN	CCTCCGTATAAG
GCGTGCCATGGN	CGCGTGCCATGG
CGGTTATCTACN	CCGGTTATCTAC
TGCACCTTGGCN	CTGCACCTTGGC
GGAGTGTAAAAN	GGGAGTGTAAAA
CGCTCTGTCAAN	CCGCTCTGTCAA
CGCCTGGAGGGN	CCGCCTGGAGGG
AGAGCCCTTAAN	TAGAGCCCTTAA
AGAGGGTTGCTN	CAGAGGGTTGCT
AATATACCTTCN	TAATATACCTTC
TTTTGGTATTAN	TTTTTGGTATTA
AATCATTGTCCN	CAATCATTGTCC
TTCTCTCTACTN	TTTCTCTCTACT
ATTCCGCGTCCN	GATTCCGCGTCC
AAAGCGTCTCGN	GAAAGCGTCTCG
GAGTATGTCAAN	GGAGTATGTCAA
GGGTAGCCTTGN	CGGGTAGCCTTG
TGTCGCCGCCAN	GTGTCGCCGCCA
GGATCATTCGTN	GGGATCATTCGT
ATCGCAACTATN	CATCGCAACTAT
GGGAACCAAATN	TGGGAACCAAAT
CACGCGGTGTGN	CACGGCGGTGTG
CGTTGCTAGGAN	CCGTTGCTAGGA
GGTACCTCCTTN	CGGTACCTCCTT
ATCCGTATGCAN	CATCCGTATGCA
GGCGCACAGGAN	GGGCGCACAGGA
ATGCTATATTGN	GATGCTATATTG
AGAGAGAAGATN	GAGAGAGAAGAT
CTCTAATTCTCN	GCTCTAATTCTC
TTCAATGGGGAN	GTTCAATGGGGA
TCTGAGTAACGN	CTCTGAGTAACG
TGTTAAGCCGTN	TTGTTAAGCCGT
CTCTAACCTTCN	TCTCTAACCTTC
ATGAAGATGTCN	TATGAAGATGTC
AGCGCTTGTTAN	CAGCGCTTGTTA
GAACATAGGTGN	AGAACATAGGTG
TAATCGAAGGGN	GTAATCGAAGGG
CACCCTTGCCCN	CCACCCTTGCCC
GTTATAGAAAGN	CGTTATAGAAAG
TCCTCAACTCTN	TTCCTCAACTCT
GGTCGGAGATCN	GGGTCGGAGATC
TGCCGGCTTACN	CTGCCGGCTTAC
AAATCTTGAAGN	AAAATCTTGAAG
CCTAGGCGCGGN	TCCTAGGCGCGG
CACATCCAGGAN	ACACATCCAGGA
CACACACACTCN	CCACACACACTC
CACAGGTTCTGN	GCACAGGTTCTG
TTTGGCCACCCN	ATTTGGCCACCC
CGAAAATGTTTN	GCGAAAATGTTT
CATTTCAAGGCN	GCATTTCAAGGC
CCATGGAGGCCN	CCCATGGAGGCC
CTCATTCCAGTN	CATCATTCCAGT
CGTGACACCGCN	CCGTGACACCGC
TTACTGATCGCN	ATTACTGATCGC
TAAACTGGCGTN	GTAAACTGGCGT
AGCTCCGAAGAN	CAGCTCCGAAGA
CATATATTTGAN	CCATATATTTGA
TAGGTTCGATGN	CTAGGTTCGATG
AACATCTGGAGN	TAACATCTGGAG
GGCGGGCACTTN	GGGCGGGCACTT
AATACCGATCTN	TAATACCGATCT
TACATATGAGCN	ATACATATGAGC
CGGCGCGAAGAN	GCGGCGCGAAGA
TGGGACCTCGGN	CTGGGACCTCGG
CCACGTCACGAN	CCCACGTCACGA
CCTACTTCGTAN	GCCTACTTCGTA
CCATGATAAAGN	CCCATGATAAAG
GTCCCTTCTCAN	GTTCCCTTCTCA
GACTTTGAAAGN	CGACTTTGAAAG
CTGCGCCGCTCN	GCTGCGCCGCTC
CTTTTAACCGTN	CTTTTTAACCGT
CATATAGACAAN	TCATATAGACAA
AATATACAATAN	TAATATACAATA
CTACGGGATAGN	GCTACGGGATAG
TTCCCTTCTCAN	GTTCCCTTCTCA
CCGCATAGTGCN	CCCGCATAGTGC
CTGGCCGTCGAN	ACTGGCCGTCGA
TACAATGATCTN	TAACAATGATCT
TCTAGGGTTCCN	CTCTAGGGTTCC
TTTAGGTTTCGN	CTTTAGGTTTCG
ACTAACGGGAAN	TACTAACGGGAA
GGAGACGAGTAN	GCGAGACGAGTA
CATAAACCTCGN	ACATAAACCTCG
CGGCGCAGAATN	GCGGCGCAGAAT
GCTCGACCGATN	CGCTCGACCGAT
AGTAACAACGCN	CAGTAACAACGC
CTCGAGGGGTGN	ACTCGAGGGGTG
CTAGCCTTGAGN	GCTAGCCTTGAG
TAGTCACAGCAN	TAGGTCACAGCA
GCGATAGCCCGN	TGCGATAGCCCG
ATGTCACGTGGN	CATGTCACGTGG
GGGTGCAGCTGN	AGGGTGCAGCTG
GCTCCTCACCGN	TGCTCCTCACCG
TGAGATCTTGAN	GTGAGATCTTGA
CATATAACTGAN	ACATATAACTGA
TGGCATGCGCCN	CTGGCATGCGCC
AGTTACATTGCN	GAGTTACATTGC
CCCGGGGTAACN	CCCCGGGGTAAC
CCACGAAGATAN	GCCACGAAGATA
CGCAATATCTAN	CGGCAATATCTA
GAATGTCCTGGN	GGAATGTCCTGG
TATAGGTTTAGN	CTATAGGTTTAG
TCGACGGAAAGN	GTCGACGGAAAG
TTGTCGATTAAN	GTTGTCGATTAA
AACGAACTATTN	AAACGAACTATT
AAGGCCGAGTTN	GAAGGCCGAGTT
TTTTGTCGCACN	TTTTTGTCGCAC
CCGAAGCAGTCN	CCGGAAGCAGTC
TCCTCCAAGGCN	ATCCTCCAAGGC
GACATTGCCAAN	TGACATTGCCAA
TCGGCCTCTCTN	ATCGGCCTCTCT
ATCGCCGTTTTN	TATCGCCGTTTT
TTAATATAAGTN	TTTAATATAAGT
AACATGAGAACN	AAACATGAGAAC
ACAGCCAGTCGN	TACAGCCAGTCG
CTGATATAGTCN	ACTGATATAGTC
TACACTAGTCCN	CTACACTAGTCC
TTGTGGGCTCGN	CTTGTGGGCTCG
ACGGGTCTGAGN	CACGGGTCTGAG
GCCTCCGGCTGN	GGCCTCCGGCTG
ACGAAAGAAAAN	CACGAAAGAAAA
TGAAAGTCCTGN	GTGAAAGTCCTG
TTATAGATCAAN	GTTATAGATCAA
CGCTACATCATN	CCGCTACATCAT
ACAGTAATGGAN	CACAGTAATGGA
CGATCTAAGGCN	CCGATCTAAGGC
ATCTCATATAGN	AATCTCATATAG
TAGTATCGGTTN	ATAGTATCGGTT
TAACTATAGTGN	ATAACTATAGTG
AATCAGCCTATN	AAATCAGCCTAT
TTCGGTTGGGTN	TTTCGGTTGGGT
ATTATATGGGGN	CATTATATGGGG
GGCCTGCCTTCN	CGGCCTGCCTTC
TAAAATGGCAAN	TTAAAATGGCAA
TTCTTTAAACAN	ATTCTTTAAACA
CGAGACGAGTAN	GCGAGACGAGTA
CGTTCTTACTCN	CGGTTCTTACTC
GATTACATTGCN	GAGTTACATTGC
CTATGGCTAGCN	CCTATGGCTAGC
ATCAAACGGTAN	AATCAAACGGTA
AGGCGGCATGAN	CAGGCGGCATGA
GTTTGTGAGGCN	AGTTTGTGAGGC
GTCCCGCGGGCN	TGTCCCGCGGGC
ACAATTGAAGAN	CACAATTGAAGA
CCGTGGCCCTCN	ACCGTGGCCCTC
TAGTCCTCGTAN	CTAGTCCTCGTA
TGGCAGTCTTCN	ATGGCAGTCTTC
CCTCAAATATCN	CCTCAAAATATC
GTATATTTCGAN	CGTATATTTCGA
GTGCTTTCCTCN	GATGCTTTCCTC
AGTTTTTATAGN	TAGTTTTTATAG
ATGCCAGCAAGN	CATGCCAGCAAG
CCACATAGAGCN	TCCACATAGAGC
GAGGGCCGAACN	GGAGGGCCGAAC
GCCTTATCGAGN	GGCCTTATCGAG
AGTCGGAGGAAN	CAGTCGGAGGAA
GCTCTTGGACAN	TGCTCTTGGACA
GCACTCACGGAN	GGCACTCACGGA
TGGAGGCTTGCN	TTGGAGGCTTGC
TTGCAATATGCN	GTTGCAATATGC
CGCAGGAACATN	CCGCAGGAACAT
AGGAATAGCAGN	TAGGAATAGCAG
GTTCGTCTCTAN	GTTTCGTCTCTA
TTAAAGTGGCTN	TTTAAAGTGGCT
CGAACATCGGAN	CAGAACATCGGA
TTCGAGACATTN	TTTCGAGACATT
AGGTCACAGCAN	TAGGTCACAGCA
CCTTGAGACTAN	ACCTTGAGACTA
CCTCAGATTAGN	CCCTCAGATTAG
CTGTACTCGCCN	GCTGTACTCGCC
CGAGTGGGCAAN	CCGAGTGGGCAA
CTATTTTTACTN	GCTATTTTTACT
ACACTCAGGTCN	AACACTCAGGTC
TGGAATAGCAGN	TAGGAATAGCAG
GATGTCCGACCN	GAATGTCCGACC
TGATTCATAATN	TCGATTCATAAT
ACCGCTAGCAGN	AACCGCTAGCAG
CCGCGAACCGCN	CCCGCGAACCGC
CAGCACGGAATN	GCAGCACGGAAT
CGCCCTCAGTTN	CCGCCCTCAGTT
TGGCAGTTGTGN	TTGGCAGTTGTG
CGGTTCATGCTN	CCGGTTCATGCT
GGAATACATGAN	GGAAATACATGA
CCGACCCCGGAN	CACGACCCCGGA
CCAATTGACGGN	CCCAATTGACGG
ATGCAGTCTTCN	ATGGCAGTCTTC
GGGTACGACAGN	GGGGTACGACAG
TTACTACAGTTN	TTTACTACAGTT
CATCATTTTTCN	CATCATTTTTTC
GATTGTTGAACN	TGATTGTTGAAC
GCGAAAGTTGTN	GGCGAAAGTTGT
TCTTGTATCCAN	TGCTTGTATCCA
GGGCCTACTTTN	CGGGCCTACTTT
AGCGGAACCGAN	TAGCGGAACCGA
CATCATTGTCCN	CAATCATTGTCC
ATCTGCAGAAAN	GATCTGCAGAAA
TTTCCCGTGCAN	TATTCCCGTGCA
CGACCATGTCGN	ACGACCATGTCG
GACCCCTGCAGN	CGACCCCTGCAG
TTGCAGTTGTGN	TTGGCAGTTGTG
CTATCTTTCGCN	CTTATCTTTCGC
GGCTGCATTACN	GGGCTGCATTAC
AGGAGTCTGTCN	AAGGAGTCTGTC
AGGGGCTGTTCN	AAGGGGCTGTTC
TTAAAAAATAGN	CTTAAAAAATAG
AAAATTGAATGN	ACAAATTGAATG
ACACTTTAAAGN	CACACTTTAAAG
AGGCCTGAAGCN	AAGGCCTGAAGC
CGGCCTACTTTN	CGGGCCTACTTT
ATACGTACCGCN	AATACGTACCGC
GCACTCGGGGAN	CGCACTCGGGGA
GGAGAGTGCTAN	AGGAGAGTGCTA
CGGGACCTCGGN	CTGGGACCTCGG
TTAATGCCTGGN	TTAAATGCCTGG
AAATGTCCGTCN	AAAATGTCCGTC
GAATCTGGGCCN	CGAATCTGGGCC
TTTCTACACACN	TTTTCTACACAC
GGGGATCCCATN	TGGGGATCCCAT
GTGCTATATTGN	GATGCTATATTG
GGAAGCGTTAAN	TGGAAGCGTTAA
GGCGAACGATCN	TGGCGAACGATC
GGTTCTTACTCN	CGGTTCTTACTC
CCGGCGGTGTGN	CACGGCGGTGTG
GTGCGAAATAAN	GCTGCGAAATAA
TTTATACAGTTN	TTTACTACAGTT
GATGTATATTGN	GATGCTATATTG
CCTTCAGGATAN	CTCTTCAGGATA
CAGGTGAACCCN	TCAGGTGAACCC
TCGAACGTGATN	ATCGAACGTGAT
GTCGCAGGAATN	TGTCGCAGGAAT
AGCAGTGTTGAN	CAGCAGTGTTGA
TCGTGGGCGCGN	ATCGTGGGCGCG
ATTGGCCACCCN	ATTTGGCCACCC
TACATCTGGAGN	TAACATCTGGAG
AAGAGTCTGTCN	AAGGAGTCTGTC
CATAATGTGGGN	ACATAATGTGGG
GTCGACTTTGGN	CGTCGACTTTGG
TCCGTACGCAGN	CTCCGTACGCAG
TACCTGATGCTN	ATACCTGATGCT
GCGAAATGTTTN	GCGAAAATGTTT
ATGGCTGTTGCN	ACTGGCTGTTGC
CATGCTACTTGN	GCATGCTACTTG
ACATCCAGTTCN	GACATCCAGTTC
GCCTACGCTACN	AGCCTACGCTAC
AGTGAGCCTCCN	AGTGAGCACTCC
CCTCGACCGATN	CGCTCGACCGAT
GCACTTCGACCN	GGCACTTCGACC
GGAACGACTCTN	TGGAACGACTCT
CTTCGCGCTAAN	ACTTCGCGCTAA
TCTCTTTCGATN	TCGTCTTTCGAT
TTAAATGGCAAN	TTAAAATGGCAA
GAAAACGCAGAN	CGAAAACGCAGA
TCGATAAAGGTN	CTCGATAAAGGT
TATAGTGTCCCN	TAATAGTGTCCC
AATGTCCGACCN	GAATGTCCGACC
AGCATATATGTN	TAGCATATATGT
CACGCTAACTTN	CACCGCTAACTT
CTACGACAACAN	CATACGACAACA
ATCATTTTTTCN	CATCATTTTTTC
ATCCGCGAAACN	CATCCGCGAAAC
ACCGCGAACGTN	ACTCGCGAACGT
AATAGCTCATCN	TAATAGCTCATC
TACGCCCTGGTN	TACAGCCCTGGT
GAATGGCGTCCN	TGAATGGCGTCC
TGCCATACGAAN	TTGCCATACGAA
AGTGGTGGATTN	ACGTGGTGGATT
ACGCAGGAGGTN	GACGCAGGAGGT
CCGCCTCAGTTN	CCGCCCTCAGTT
GGAGAAGAGATN	AGGAGAAGAGAT
CAGTGCATCCTN	CAAGTGCATCCT
CGGTAGCCTTGN	CGGGTAGCCTTG
ACAGTTCCCACN	AACAGTTCCCAC
CCCCCTCAGTTN	CCGCCCTCAGTT
TGGAACCAAATN	TGGGAACCAAAT
ATACGCTAGTGN	ATACAGCTAGTG
GGCCGCGTGCTN	GGCCCGCGTGCT
ACTCTTTGCTAN	ATCTCTTTGCTA
GCACACGGAATN	GCAGCACGGAAT
TGATGACTTATN	TTGATGACTTAT
TGGCTGATCATN	TGGGCTGATCAT
GATAAACTGCCN	TGATAAACTGCC
GCCCCAGCAGTN	GGCCCCAGCAGT
GTATGCACGTGN	CGTATGCACGTG
AGAACATCGGAN	CAGAACATCGGA
CTCGATAAGGTN	CTCGATAAAGGT
TAGCCCCCCGCN	TTAGCCCCCCGC
TATCCCGTTTTN	TATCGCCGTTTT
GCTATCATGTGN	GACTATCATGTG
CGGCCCTTTAAN	TCGGCCCTTTAA
AACGTCGAGTAN	ATACGTCGAGTA
TATCCCGTGCAN	TATTCCCGTGCA
GAGTTCCGCCCN	GGAGTTCCGCCC
AGCTCCGCAAGN	AGCTCCTGCAAG
TGAACGAACATN	GTGAACGAACAT
GCAGCAGAGCAN	GACAGCAGAGCA
CCACTTTAAAGN	CACACTTTAAAG
CTGATAGACGGN	GCTGATAGACGG
AGAACATGGTGN	AGAACATAGGTG
ACGCTAACCTAN	ACTGCTAACCTA
CAGCCCGCTGCN	CAGCCCCGCTGC
TACCTCGGCGAN	GTACCTCGGCGA
CTCAGAAAGCTN	TCTCAGAAAGCT
AAGTATCGGTTN	ATAGTATCGGTT
GGTTTCATCGTN	GGTTATCATCGT
GATGCTGAAATN	GATGCTGAAAAT
TATGATTTGCCN	TAATGATTTGCC
AGGTATTGATGN	AGGGTATTGATG
GGCGATTGGGCN	AGGCGATTGGGC
AGGGCCGCGCCN	GAGGGCCGCGCC
CTAGTTCGATGN	CTAGGTTCGATG
CCGTGCGTGTGN	GCCGTGCGTGTG
GTCGCCATCGTN	GTACGCCATCGT
CCTGCCTAATAN	GCCTGCCTAATA
GACTAATTATCN	GACTAATTGATC
AATGCATTAGAN	AGATGCATTAGA
TGGGATCCCATN	TGGGGATCCCAT
GCGGACGAGTAN	GCGAGACGAGTA
ACACAACTTTGN	ACTACAACTTTG
CATCTTCCAGTN	CATCATTCCAGT
CTAGAAACCAGN	CCTAGAAACCAG
TAGTAAGCTATN	TAAGTAAGCTAT
CAGCCCCATAGN	TCAGCCCCATAG
CTCGTTAACTCN	CTTCGTTAACTC
AAGACCTAACAN	ACAGACCTAACA
CTGATGCTCGCN	CCTGATGCTCGC
ACGTGGGAAAGN	ACGTGGGAAAAG
GATTCCGAACTN	GAATTCCGAACT
TGCCGAAGACCN	TGCCCGAAGACC
TATACCGATCTN	TAATACCGATCT
ATGACGAGGCCN	AGTGACGAGGCC
TACCGGGTAATN	TGACCGGGTAAT
CCGATAAAGGTN	CTCGATAAAGGT
AAGTCAGGCGCN	AAAGTCAGGCGC
CTGGAGATTGAN	CTTGGAGATTGA
TATTGCGAAACN	TATTGCGAAAAC
CATCGGGGTTTN	CATCGGGGGTTT
CGCTTGCGGGCN	GCGCTTGCGGGC
TAAGACGATAGN	GTAAGACGATAG
ATACATTGAGCN	ATACATATGAGC
GTAAGCGCTGGN	GTTAAGCGCTGG
ACTTGGACTATN	ACTTGGGACTAT
TCGGGACGCCAN	ATCGGGACGCCA
TTCAATGTCTTN	GTTCAATGTCTT
AGCCGAGCTCCN	AAGCCGAGCTCC
TAACATGATCTN	TAACAATGATCT
GTATATTTCAGN	GTAATATTTCAG
ACGGACATTATN	CACGGACATTAT
TTCGAAAGGCTN	GTTCGAAAGGCT
TTAGCCCCCGCN	TTAGCCCCCCGC
CGCGCGAGTTAN	CTGCGCGAGTTA
AAGTAAGCTATN	TAAGTAAGCTAT
CAGCAGCCCATN	CAGCAGCACCAT
GATGTTACCGAN	GAATGTTACCGA
TAAACTAGCCGN	TAAAACTAGCCG
GGAAAATGTTTN	GCGAAAATGTTT
TTCCTCACTCTN	TTCCTCAACTCT
TGGGGTGGCAAN	TTGGGGTGGCAA
CCTGAGTAACGN	CTCTGAGTAACG
CTATGGAACAGN	CTATGGAAACAG
GCTTTTAACCTN	TGCTTTTAACCT
GTTCCTTCTCAN	GTTCCCTTCTCA
CTCGCGAGTTAN	CTGCGCGAGTTA
GCTAATTGATCN	GACTAATTGATC
AACAATGATCTN	TAACAATGATCT
ACGGCGGTGTGN	CACGGCGGTGTG
TGGTTAAATCTN	TGGTTAAAATCT
TGAGAGCTCACN	TGGAGAGCTCAC
GCGGGTGTCAGN	AGCGGGTGTCAG
GTATAGATCAAN	GTTATAGATCAA
GTTACGCGTCCN	AGTTACGCGTCC
GTCATCATCGAN	GTTCATCATCGA
GGGGTCTTCGAN	CGGGGTCTTCGA
CGAATGTGTTTN	CGAAATGTGTTT
AGCCCCGCTGCN	CAGCCCCGCTGC
CTAAGAAAGGAN	CTTAAGAAAGGA
CTATTTAACCGN	GCTATTTAACCG
ACCGCTATAGCN	AACCGCTATAGC
CTTAAGAAGGAN	CTTAAGAAAGGA
ACAACCTCCCAN	TACAACCTCCCA
TCATTCGATCAN	TACATTCGATCA
GCAATTCATGCN	CGCAATTCATGC
ATCGGGGGTTTN	CATCGGGGGTTT
CGTGGTGGATTN	ACGTGGTGGATT
TATCATCCGCTN	TATCAATCCGCT
CCTAGAAACCGN	CCTAGAAACCAG
GGAGACTCAGTN	CGGAGACTCAGT
GGTCGGGAGTTN	GTGTCGGGAGTT
ACTAAACCTCGN	ACATAAACCTCG
AACAGCTAGTGN	ATACAGCTAGTG
TAGTTTTATAGN	TAGTTTTTATAG
AACCTCCGACTN	AACCTCCTGACT
TCCAAAGGTGGN	TCCCAAAGGTGG
GTTCCGCGTCCN	GATTCCGCGTCC
CCCCGTATAAGN	CCTCCGTATAAG
CCAGCAGTCGAN	CCAGGCAGTCGA
TATATAGACAAN	TCATATAGACAA
CGACAGTCTAAN	CGGACAGTCTAA
CATCCAACTATN	CATCGCAACTAT
ATCTCCCCTATN	ATCGTCCCCTAT
GCATCCGACTAN	GGCATCCGACTA
TATCAATCGCTN	TATCAATCCGCT
AATAAACGGTAN	AATCAAACGGTA
TGCTTTAACCTN	TGCTTTTAACCT
CTCTTGGCCGCN	TCTCTTGGCCGC
TACACCTCCCAN	TACAACCTCCCA
GTGGCTTATAGN	GATGGCTTATAG
TTGCTGGGTGTN	CTTGCTGGGTGT
CATGACTAGGGN	CCATGACTAGGG
TTGCAGATTTCN	TTGCCAGATTTC
TAAAATGATCTN	TAACAATGATCT
GACGGCACCGTN	TGACGGCACCGT
GTCTCTAGTAGN	GATCTCTAGTAG
TTTCGGTGGGTN	TTTCGGTTGGGT
TGCGCGAGTTAN	CTGCGCGAGTTA
GCACCGCCAGTN	GCCACCGCCAGT
TTACCGTCAGAN	TCTACCGTCAGA
ACTTGGGACTTN	ACTTGGGACTAT
TCACATGGTGTN	GTCACATGGTGT
TCAAATAGGGGN	GTCAAATAGGGG
CTAAGCATCTCN	ACTAAGCATCTC
CCCGCGAAGACN	ACCCGCGAAGAC
GCCTAATTCTCN	GCTCTAATTCTC
ATAGTATCGTTN	ATAGTATCGGTT
CCAGAGCCGATN	CCAGGAGCCGAT
AAGGCTGAAGCN	AAGGCCTGAAGC
TCTCGAAAGCTN	TCTCAGAAAGCT
ACCGATCCTTAN	ACCCGATCCTTA
TGGTCACAGCAN	TAGGTCACAGCA
AGACATAGGTGN	AGAACATAGGTG
TAGGTCGTCACN	GTAGGTCGTCAC
CGGGTCTTCGAN	CGGGGTCTTCGA
ACCTAGTGATTN	ACCCTAGTGATT
GCGCGCAGAATN	GCGGCGCAGAAT
TCGCCCCTTCGN	CTCGCCCCTTCG
TTATGACTTATN	TTGATGACTTAT
TCAGCCCTGGTN	TACAGCCCTGGT
AAGCCTGAAGCN	AAGGCCTGAAGC
TTACCGTCCCCN	TTTACCGTCCCC
CTTAAAAATAGN	CTTAAAAAATAG
CAGGCAGTCGAN	CCAGGCAGTCGA
TAAAAATTCAGN	TAGAAAATTCAG
CAGCTCTTGGTN	CAGCCTCTTGGT
TACAGGATGAAN	GTACAGGATGAA
ACGTCATTTTCN	ACCGTCATTTTC
TACATCTCTGTN	TGACATCTCTGT
AACCTGAGGGTN	AAACCTGAGGGT
CCCGATCCTTAN	ACCCGATCCTTA
GCATTTCAGGCN	GCATTTCAAGGC
GGAATTACTTGN	AGGAATTACTTG
CAGGAGCCGATN	CCAGGAGCCGAT
ATACGACAACAN	CATACGACAACA
GAAAGCAGGTCN	GTAAAGCAGGTC
ACCTCATTTTCN	ACCGTCATTTTC
CGGCCCTCCGCN	CGGCCCTCCGGC
CACACTAGTCCN	CTACACTAGTCC
CTTTTTACCGTN	CTTTTTAACCGT
CCCCGAACCGCN	CCCGCGAACCGC
CCGGGTCTGAGN	CACGGGTCTGAG
ACCGACACAATN	ACCCGACACAAT
ATCAGCTAGTGN	ATACAGCTAGTG
TAGCCCCATAGN	TCAGCCCCATAG
AGACTCGAATCN	ACGACTCGAATC
CGCTGCCATGGN	CGCGTGCCATGG
TACTAGGTGTTN	TACTGAGGTGTT
TTTTATGGGCCN	TATTTATGGGCC
CGCGCTTGTTAN	CAGCGCTTGTTA
TAAATGCCTGGN	TTAAATGCCTGG
ATACTGATGCTN	ATACCTGATGCT
ACGTACGAATCN	ATCGTACGAATC
CAGCTCCGATAN	CAAGCTCCGATA
ATCTGCAGGGTN	ATTCTGCAGGGT
ACGATATAGTCN	ACTGATATAGTC
CTTCTTAACTCN	CTTCGTTAACTC
AGTCGATTATTN	AGGTCGATTATT
ATCCTGATGCTN	ATACCTGATGCT
TAGGTTATAAGN	TGAGGTTATAAG
GGGGCCGCGCCN	GAGGGCCGCGCC
AACTCCCATTCN	AACTCCTCATTC
GACAGGGGGACN	AGACAGGGGGAC
CAGGTTCGATGN	CTAGGTTCGATG
CATATGAGAACN	TCATATGAGAAC
CGATCCCGGGGN	CAGATCCCGGGG
GTCAATTGTCAN	GTCAAATTGTCA
CCCTACATCATN	CCGCTACATCAT
TTAAGCTTGATN	TTTAAGCTTGAT
CACGGGGGTTTN	CATCGGGGGTTT
GCGCCATCCGCN	GCGGCCATCCGC
CAGTACACGATN	CCAGTACACGAT
TAGTCGACCCCN	ATAGTCGACCCC
TAGCTCCGGAAN	TAGCTCACGGAA
CTTATCTTCGCN	CTTATCTTTCGC
AGGTGGGAAAAN	AAGGTGGGAAAA
GTCTAGACGAAN	GATCTAGACGAA
GGCCCAGCAGTN	GGCCCCAGCAGT
TAATGTGTCCCN	TAATAGTGTCCC
ACTCGCGACGTN	ACTCGCGAACGT
GCCAATACATCN	AGCCAATACATC
ACAATAGCGCTN	ACAATATGCGCT
CTGCGCTGGCGN	CCTGCGCTGGCG
GATTAGTGCATN	GTATTAGTGCAT
ATCTTTAAACAN	ATTCTTTAAACA
GCTTGTATCCAN	TGCTTGTATCCA
TTTAAGCTTGTN	TTTAAGCTTGAT
ACCTGAAACGCN	ACCTGATAACGC
TATCCACCCTAN	TATCCACGCCTA
ATCTTAAGATTN	AATCTTAAGATT
CGCACTCGGGAN	CGCACTCGGGGA
GTGCTGAAAATN	GATGCTGAAAAT
TCTAGGCGCGGN	TCCTAGGCGCGG
AGTTCTCAAATN	CAGTTCTCAAAT
CATCGCGAAACN	CATCCGCGAAAC
GACGCCATCGTN	GTACGCCATCGT
GGTTAAAATCTN	TGGTTAAAATCT
GTACCCATCGTN	GTACGCCATCGT
TGAGGCACCGTN	TGACGGCACCGT
ACGTGGGCGCGN	ATCGTGGGCGCG
GTCTCCGCCCGN	GTCATCCGCCCG
CCCCTTTCGAAN	CCCGCTTTCGAA
TCTCAGAAGCTN	TCTCAGAAAGCT
ATCGTGGCGCGN	ATCGTGGGCGCG
CTCACCTTGGCN	CTGCACCTTGGC
GGAACGAACATN	GTGAACGAACAT
GGAGAGCGCGCN	GGGAGAGCGCGC
CCCGCAACCGCN	CCCGCGAACCGC
ACTCGTCTCACN	ACTCGTCTCAAC
TACAACCTCCAN	TACAACCTCCCA
TCCCAAGGTGGN	TCCCAAAGGTGG
ACCTATCTTGTN	ACCTTATCTTGT
ATCAATCCGCTN	TATCAATCCGCT
AGATGAGGCTGN	ACGATGAGGCTG
AAACATGAGACN	AAACATGAGAAC
TAATGATTGCCN	TAATGATTTGCC
GGTCTAGCCCTN	GGGTCTAGCCCT
CCGCTACTCATN	CCGCTACATCAT
AGGTCATTATTN	AGGTCGATTATT
CATCGCACTATN	CATCGCAACTAT
CTTAGGTTTCGN	CTTTAGGTTTCG
TAAATACCTTAN	TAAAATACCTTA
AAACTGAGGGTN	AAACCTGAGGGT
ATTCTCAGGGTN	ATTCTGCAGGGT
GAATATTTCAGN	GTAATATTTCAG
TGTTAAAATCTN	TGGTTAAAATCT
CCGCTGGAGGGN	CCGCCTGGAGGG
ACCGCTAACTTN	CACCGCTAACTT
CACTGTCTAGTN	CGACTGTCTAGT
GTTCGAAGGCTN	GTTCGAAAGGCT
CTAAAAAATAGN	CTTAAAAAATAG
ACTAAACTTTGN	ACTACAACTTTG
GATCTATCTCAN	GATCTAATCTCA
GTACGGGATAGN	GCTACGGGATAG
GTATTAGTGCTN	GTATTAGTGCAT
GTGACTATTCTN	GTGACTATTTCT
AGGTGATTATTN	AGGTCGATTATT
TCATAGAAGCGN	TCGATAGAAGCG
GCTCTATTCTCN	GCTCTAATTCTC
AGGCAGTCTTCN	ATGGCAGTCTTC
AGGCCGGGATTN	AAGGCCGGGATT
AAACGACTATTN	AAACGAACTATT
CTACACTGTCCN	CTACACTAGTCC
TTTCGGTTGGTN	TTTCGGTTGGGT
AAGCTCCGATAN	CAAGCTCCGATA
GTCAATGGGGAN	GTTCAATGGGGA
ATACTATAGTGN	ATAACTATAGTG
TTCCCACCCTAN	TTCCGCACCCTA
ATCGCCTCTCTN	ATCGGCCTCTCT
CCGCAGGACATN	CCGCAGGAACAT
GCCGTAAACATN	GCCGCTAAACAT
GGTATCATAATN	GGTATCTATAAT
CCCATGATAAGN	CCCATGATAAAG
TCACATAGAGCN	TCCACATAGAGC
GTAAGCAGGTCN	GTAAAGCAGGTC
GCATTCAAGGCN	GCATTTCAAGGC
CGACTTGAAAGN	CGACTTTGAAAG
ACCGTGCCCTCN	ACCGTGGCCCTC
AAACCTGGGGTN	AAACCTGAGGGT
TGGGCTGTCATN	TGGGCTGATCAT
TTCTGCAGGGTN	ATTCTGCAGGGT
CCGGAGCAGTCN	CCGGAAGCAGTC
GTTCCCTTCTAN	GTTCCCTTCTCA
CCTGATAACGCN	ACCTGATAACGC
TCTGGTTTCTGN	TCTGGTTTCTAG
TCGTGGCTGTCN	TTCGTGGCTGTC
GATGTTTCCTCN	GATGCTTTCCTC
TCTGGTTCTAGN	TCTGGTTTCTAG
CAGACATCGGAN	CAGAACATCGGA
CTGCGAAATAAN	GCTGCGAAATAA
CCGGACATTATN	CACGGACATTAT
CTCTCGGGTACN	ACTCTCGGGTAC
TTGATGACTTTN	TTGATGACTTAT
TCGCCCTTTAAN	TCGGCCCTTTAA
TGGGATTGCTTN	TGGAGATTGCTT
ACCAATATGTAN	ACCAATATAGTA
TCTCTTTGCTAN	ATCTCTTTGCTA
ATCGTCCCTATN	ATCGTCCCCTAT
GAATGTACCGAN	GAATGTTACCGA
TATTCCGTGCAN	TATTCCCGTGCA
GGTGCTATAGGN	AGGTGCTATAGG
GGATAGATCGCN	GGAATAGATCGC
CCGTCATTTTCN	ACCGTCATTTTC
CACCGTATGCAN	CATCCGTATGCA
GGGATCTTCGTN	GGGATCATTCGT
TAAGCTTCATGN	TAAGCCTTCATG
CCGTTATCTACN	CCGGTTATCTAC
CTTGTGGGTGTN	CTTGCTGGGTGT
ATTCTTTAACAN	ATTCTTTAAACA
GCTGGAAATAAN	GCTGCGAAATAA
TCCACAAGAGCN	TCCACATAGAGC
TCTTCAGGATAN	CTCTTCAGGATA
AGACAGGGGGCN	AGACAGGGGGAC
TCATGTGTCTCN	ATCATGTGTCTC
CAGTAACACGCN	CAGTAACAACGC
CATCTCCCGATN	CAGTCTCCCGAT
ACCGCCCTTAGN	ACCGCCCCTTAG
ACGTGGCCCTCN	ACCGTGGCCCTC
AGGCGGCCAGTN	AGGGCGGCCAGT
CACGACCCGGAN	CACGACCCCGGA
GAGAGAGAAGTN	GAGAGAGAAGAT
CTATAGGTTAGN	CTATAGGTTTAG
CTGTATATCAAN	TCTGTATATCAA
CGCCCCGCTGCN	CAGCCCCGCTGC
ACTCCGAACGTN	ACTCGCGAACGT
GTGTACGCCCAN	GGTGTACGCCCA
CGAATTCTCTTN	CGAATTCATCTT
TGTGTGCATTTN	TGTGTGCGATTT
ACCCGACACATN	ACCCGACACAAT
GACAGGATGAAN	GTACAGGATGAA
CCCATGCATGTN	CCCATGCAATGT
ACGATCGAATCN	ACGACTCGAATC
CTGTGGGCTCGN	CTTGTGGGCTCG
GGTTTCTAGAAN	AGGTTTCTAGAA
ACCTTATCTTTN	ACCTTATCTTGT
TGCTCTCACCGN	TGCTCCTCACCG
TGGTCTTAACAN	TCGGTCTTAACA
TACTAACGGAAN	TACTAACGGGAA
GAGGCCGCGCCN	GAGGGCCGCGCC
ACATAAGTGGGN	ACATAATGTGGG
GCAAATTGTCAN	GTCAAATTGTCA
ACCCTATGATTN	ACCCTAGTGATT
ACCGCGGTGCGN	TACCGCGGTGCG
ATTTGCCACCCN	ATTTGGCCACCC
TCGCGCATTGTN	TCGCGCATTGAT
ATCTCCAAGGCN	ATCCTCCAAGGC
ACTGATAACGCN	ACCTGATAACGC
GAGCTATATTGN	GATGCTATATTG
GAAGAGAAGATN	GAGAGAGAAGAT
ATACTGATCGCN	ATTACTGATCGC
GCCCGAAGACCN	TGCCCGAAGACC
GGAGAGCTCACN	TGGAGAGCTCAC
AGAAAATTCAGN	TAGAAAATTCAG
AGCTCCTCAAGN	AGCTCCTGCAAG
TATATCCACATN	TTATATCCACAT
ACGTACGCTTAN	TACGTACGCTTA
GTGTGCGATTTN	TGTGTGCGATTT
AAATCAGCCTTN	AAATCAGCCTAT
CAGTTCTCAATN	CAGTTCTCAAAT
CTATAGGTTTGN	CTATAGGTTTAG
ATCATATGAGCN	ATACATATGAGC
GCCTCCTGACTN	GACCTCCTGACT
AAGGGCTGTTCN	AAGGGGCTGTTC
TGGTACCGATGN	TAGGTACCGATG
ACAATCCAGGAN	ACACATCCAGGA
GCTATTTTACTN	GCTATTTTTACT
CCCTCTGTCAAN	CCGCTCTGTCAA
CATCAAACGAAN	ACATCAAACGAA
ACATAACCTCGN	ACATAAACCTCG
CCCAAAGGTGGN	TCCCAAAGGTGG
CCGATCTAGGCN	CCGATCTAAGGC
GCAATAGCTACN	GCAAATAGCTAC
GGGCTGATCATN	TGGGCTGATCAT
